[
bgggggggggggggggggggggggggggggggggggggga,
f                         1            e,
f      0                x    x    x    e,
f         1             lAAAAk    lAAAAr,
f                                    1 e,
f                       x    x    x    e,
tAAAAAAAAAAAi           lAAAAk    nAAAAr,
f           B                     y    e,
f    1      B                          e,
f           B                     x    e,
tAAAAqAw  vAk           z    z    lAAAAr,
f    y                                 e,
f                1                     e,
f                                      e,
f    x                                 e,
tAAAApAw  vAi           z    z    jAAAAr,
f           B                     y 1  e,
f    1      B                          e,
f           B                     x    e,
tAAAAAAAAAAAk           jAAAAi    nAAAAr,
f                       y    y    y    e,
f                               1      e,
f                       jAAAAi    jAAAAr,
f       1               y 1  y    y    e,
f                                      e,
dhhhhhhhhhhhhhhhhhhhhhhhhhhhhhhhhhhhhhhc,
]


